TTT TTTTTT
ATT ATTTTT
TGT TGTTTT
TAT TATTTT
TTA TTAAAA
TA  TATTT
TTC TTCTTT